10 10 10 10 10 10 10 10 10 10 10 10 10 10 10 10 
10 10 10 10 10 10 10 10 10 10 10 10 10 10 10 10 
10 10 10 10 10 10 10 10 10 10 10 10 10 10 10 10 
10 10 10 10 10 10 10 10 10 10 10 10 10 10 10 10 
10 10 10 1 5 1 0 1 91 0 0 6 10 10 10 10 
10 10 10 1 1 1 1 1 1 0 0 0 10 10 10 10 
10 10 10 7 1 1 1 1 1 1 0 81 10 10 10 10 
10 10 10 3 0 0 0 0 0 92 0 0 10 10 10 10 
10 10 10 7 1 1 1 0 0 7 1 1 10 10 10 10 
10 10 10 4 0 2 1 0 0 7 82 0 10 10 10 10 
10 10 10 10 10 10 10 10 10 10 10 10 10 10 10 10 
10 10 10 10 10 10 10 10 10 10 10 10 10 10 10 10 
10 10 10 10 10 10 10 10 10 10 10 10 10 10 10 10 
10 10 10 10 10 10 10 10 10 10 10 10 10 10 10 10 
