10 10 10 10 10 10 10 10 10 10 10 10 10 10 
10 10 10 10 10 10 10 10 10 10 10 10 10 10 
10 10 10 10 10 10 10 10 10 10 10 10 10 10 
10 10 10 10 10 10 10 10 10 10 10 10 10 10 
10 10 1 5 1 0 1 9 0 0 6 10 10 10 
10 10 1 1 1 1 1 1 0 0 0 10 10 10 
10 10 7 1 1 1 1 1 1 0 8 10 10 10 
10 10 3 0 0 0 0 0 9 0 0 10 10 10 
10 10 7 1 1 1 0 0 7 1 1 10 10 10 
10 10 0 4 2 1 0 0 7 8 0 10 10 10 
10 10 10 10 10 10 10 10 10 10 10 10 10 10 
10 10 10 10 10 10 10 10 10 10 10 10 10 10 
10 10 10 10 10 10 10 10 10 10 10 10 10 10 
10 10 10 10 10 10 10 10 10 10 10 10 10 10 
