7 7 7 7 7 7 7 0 5 0
0 2 0 2 0 0 7 0 1 0
2 0 2 0 7 0 7 1 0 1
0 2 0 2 7 0 7 0 1 0
2 0 2 0 7 0 7 1 0 0
0 2 0 2 7 0 7 1 1 1 
2 0 2 0 7 0 7 1 1 0
0 0 0 0 7 0 0 0 0 0
3 0 4 0 7 0 0 0 0 6