1 5 1 0 1 9 0 0 6
1 1 1 1 1 1 0 0 0
7 1 1 1 1 1 1 0 8
3 0 0 0 0 0 9 0 0
7 1 1 1 0 0 7 1 1
0 4 2 1 0 0 7 8 0